####################
#...$..............#
#.###.#######.####.#
#.#...#.....#....#.#
#.#.$.#..+..#..$.#.#
#.#...#.....#....#.#
#.#####.#####.####.#
#..................#
####################